0900: 0130 { 180 2 ---  190 2 ---  181 2 ---  191 2 --- }
0901: 0130 { 182 2 ---  192 2 ---  181 2 ---  191 2 --- }
0902: 0130 { 182 2 ---  192 2 ---  183 2 ---  193 2 --- }
0903: 0130 { 1C8 2 ---  1D8 2 ---  1C9 2 ---  1D9 2 --- }
0904: 0130 { 1C9 2 ---  1D9 2 ---  1CA 2 ---  1DA 2 --- }
0905: 0025 { 0F8 2 ---  194 2 ---  0F8 2 ---  195 2 --- }
0906: 0025 { 0F8 2 ---  196 2 ---  0F8 2 ---  197 2 --- }
0907: 0025 { 188 2 ---  198 2 ---  189 2 ---  198 2 --- }
0908: 0025 { 18A 2 ---  19A 2 ---  18B 2 ---  19B 2 --- }
0909: 0025 { 18C 2 ---  19C 2 ---  18D 2 ---  19D 2 --- }
090A: ~
090B: ~
090C: ~
090D: ~
090E: ~
090F: ~
0910: 0130 { 1A0 2 ---  190 2 ---  1A1 2 ---  191 2 --- }
0911: 0130 { 1A2 2 ---  192 2 ---  1A1 2 ---  191 2 --- }
0912: 0130 { 1A2 2 ---  192 2 ---  1A3 2 ---  193 2 --- }
0913: 0130 { 1D8 2 ---  1D8 2 ---  1D9 2 ---  1D9 2 --- }
0914: 0130 { 1D9 2 ---  1D9 2 ---  1DA 2 ---  1DA 2 --- }
0915: 0025 { 0F8 2 ---  1B4 2 ---  0F8 2 ---  1B5 2 --- }
0916: 0025 { 0F8 2 ---  1B6 2 ---  0F8 2 ---  1B7 2 --- }
0917: 0025 { 1A8 2 ---  1B8 2 ---  1A9 2 ---  1B8 2 --- }
0918: 0025 { 1AA 2 ---  1BA 2 ---  1AB 2 ---  1BB 2 --- }
0919: ~
091A: ~
091B: ~
091C: ~
091D: ~
091E: ~
091F: ~
0920: 0130 { 1A0 2 ---  1B0 2 ---  1A1 2 ---  1B1 2 --- }
0921: 0130 { 1A2 2 ---  1B2 2 ---  1A1 2 ---  1B1 2 --- }
0922: 0130 { 1A2 2 ---  1B2 2 ---  1A3 2 ---  1B3 2 --- }
0923: 0130 { 1D8 2 ---  1E8 2 ---  1D9 2 ---  1E9 2 --- }
0924: 0130 { 1D9 2 ---  1E9 2 ---  1DA 2 ---  1EA 2 --- }
0925: 0130 { 004 6 ---  004 6 ---  004 6 ---  004 6 --- }
0926: 0130 { 004 6 ---  004 6 ---  004 6 ---  004 6 --- }
0927: ~
0928: ~
0929: ~
092A: ~
092B: ~
092C: ~
092D: ~
092E: ~
092F: ~
0930: 0130 { 1C0 2 ---  1D0 2 ---  1C1 2 ---  1D1 2 --- }
0931: 0130 { 1C2 2 ---  1D2 2 ---  1C1 2 ---  1D1 2 --- }
0932: 0130 { 1C2 2 ---  1D2 2 ---  1C3 2 ---  1D3 2 --- }
0933: 0130 { 004 6 ---  004 6 ---  004 6 ---  004 6 --- }
0934: 0130 { 004 6 ---  004 6 ---  004 6 ---  004 6 --- }
0935: 0130 { 004 6 ---  004 6 ---  004 6 ---  004 6 --- }
0936: 0130 { 004 6 ---  004 6 ---  004 6 ---  004 6 --- }
0937: ~
0938: ~
0939: ~
093A: ~
093B: ~
093C: ~
093D: ~
093E: ~
093F: ~
0940: 0130 { 1E0 2 ---  1D0 2 ---  1E1 2 ---  1D1 2 --- }
0941: 0130 { 1E2 2 ---  1D2 2 ---  1E1 2 ---  1D1 2 --- }
0942: 0130 { 1E2 2 ---  1D2 2 ---  1E3 2 ---  1D3 2 --- }
0943: 0130 { 004 6 ---  004 6 ---  004 6 ---  004 6 --- }
0944: 0130 { 004 6 ---  004 6 ---  004 6 ---  004 6 --- }
0945: 0130 { 004 6 ---  004 6 ---  004 6 ---  004 6 --- }
0946: 0130 { 004 6 ---  004 6 ---  004 6 ---  004 6 --- }
0947: ~
0948: ~
0949: ~
094A: ~
094B: ~
094C: ~
094D: ~
094E: ~
094F: ~
0950: 0130 { 1E0 2 ---  1F0 2 ---  1E1 2 ---  1F1 2 --- }
0951: 0130 { 1E2 2 ---  1F2 2 ---  1E1 2 ---  1F1 2 --- }
0952: 0130 { 1E2 2 ---  1F2 2 ---  1E3 2 ---  1F3 2 --- }
0953: 0130 { 004 6 ---  004 6 ---  004 6 ---  004 6 --- }
0954: 0130 { 004 6 ---  004 6 ---  004 6 ---  004 6 --- }
0955: 0130 { 004 6 ---  004 6 ---  004 6 ---  004 6 --- }
0956: 0130 { 004 6 ---  004 6 ---  004 6 ---  004 6 --- }
0957: ~
0958: ~
0959: ~
095A: ~
095B: ~
095C: ~
095D: ~
095E: ~
095F: ~
0960: ~
0961: ~
0962: ~
0963: ~
0964: ~
0965: ~
0966: ~
0967: ~
0968: ~
0969: ~
096A: ~
096B: ~
096C: ~
096D: ~
096E: ~
096F: ~
0970: ~
0971: ~
0972: ~
0973: ~
0974: ~
0975: ~
0976: ~
0977: ~
0978: ~
0979: ~
097A: ~
097B: ~
097C: ~
097D: ~
097E: ~
097F: ~
0980: ~
0981: ~
0982: ~
0983: ~
0984: ~
0985: ~
0986: ~
0987: ~
0988: ~
0989: ~
098A: ~
098B: ~
098C: ~
098D: ~
098E: ~
098F: ~
0990: ~
0991: ~
0992: ~
0993: ~
0994: ~
0995: ~
0996: ~
0997: ~
0998: ~
0999: ~
099A: ~
099B: ~
099C: ~
099D: ~
099E: ~
099F: ~
09A0: ~
09A1: ~
09A2: ~
09A3: ~
09A4: ~
09A5: ~
09A6: ~
09A7: ~
09A8: ~
09A9: ~
09AA: ~
09AB: ~
09AC: ~
09AD: ~
09AE: ~
09AF: ~
09B0: ~
09B1: ~
09B2: ~
09B3: ~
09B4: ~
09B5: ~
09B6: ~
09B7: ~
09B8: ~
09B9: ~
09BA: ~
09BB: ~
09BC: ~
09BD: ~
09BE: ~
09BF: ~
09C0: ~
09C1: ~
09C2: ~
09C3: ~
09C4: ~
09C5: ~
09C6: ~
09C7: ~
09C8: ~
09C9: ~
09CA: ~
09CB: ~
09CC: ~
09CD: ~
09CE: ~
09CF: ~
09D0: ~
09D1: ~
09D2: ~
09D3: ~
09D4: ~
09D5: ~
09D6: ~
09D7: ~
09D8: ~
09D9: ~
09DA: ~
09DB: ~
09DC: ~
09DD: ~
09DE: ~
09DF: ~
09E0: ~
09E1: ~
09E2: ~
09E3: ~
09E4: ~
09E5: ~
09E6: ~
09E7: ~
09E8: ~
09E9: ~
09EA: ~
09EB: ~
09EC: ~
09ED: ~
09EE: ~
09EF: ~
09F0: ~
09F1: ~
09F2: ~
09F3: ~
09F4: ~
09F5: ~
09F6: ~
09F7: ~
09F8: ~
09F9: ~
09FA: ~
09FB: ~
09FC: ~
09FD: ~
09FE: ~
09FF: ~
